28
0 47 -1 224 120 64 64 1 0 0
1 47 -1 630 120 64 64 1 0 0
2 47 -1 700 120 64 64 1 0 0
3 43 1 680 190 64 64 1 0 0
4 45 -1 680 100 64 64 1 0 0
5 43 1 880 190 64 64 1 0 0
6 46 -1 1100 251 64 64 1 0 0
7 43 1 1150 190 64 64 1 0 0
8 46 -1 1440 270 64 64 1 0 0
9 43 1 1550 220 64 64 1 0 0
10 43 1 1780 280 64 64 1 0 0
11 45 -1 1900 220 64 64 1 0 0
12 43 1 2295 160 64 64 1 0 0
13 43 1 2370 280 64 64 1 0 0
14 48 -1 2435 247 64 64 1 0 0
15 45 1 2500 110 64 64 1 0 0
16 47 -1 2600 247 64 64 1 0 0
17 43 1 2650 290 64 64 1 0 0
18 50 -1 2700 110 64 64 1 0 0
19 47 -1 2900 242 64 64 1 0 0
20 47 -1 3000 305 64 64 1 0 0
21 43 1 3350 160 64 64 1 0 0
22 46 -1 3480 240 64 64 1 0 0
23 43 1 3730 160 64 64 1 0 0
24 46 -1 3780 290 64 64 1 0 0
25 47 -1 3770 120 64 64 1 0 0
26 47 -1 3898 120 64 64 1 0 0
27 21 -1 100 70 1550 10 1 0 0