44
0 47 -1 480 100 0 0 0 380 580
1 47 -1 580 100 0 0 0 480 680
2 47 -1 670 100 0 0 0 570 770
3 45 1 450 100 0 0 70 0 0
4 47 -1 870 100 0 0 0 770 970
5 43 1 660 175 0 0 70 0 0
6 43 1 850 175 0 0 1 0 0
7 46 -1 1100 251 0 0 1 0 0
8 43 1 1150 190 0 0 1 0 0
9 46 -1 1440 270 0 0 1 0 0
10 43 1 1550 220 0 0 1 0 0
11 43 1 1780 280 0 0 1 0 0
12 45 -1 1900 220 0 0 1 0 0
13 43 1 2295 160 0 0 1 0 0
14 43 1 2370 280 0 0 1 0 0
15 48 -1 2435 247 0 0 1 0 0
16 45 1 2500 110 0 0 1 0 0
17 47 -1 2600 247 0 0 1 2559 2749
18 43 1 2650 290 0 0 1 0 0
19 50 -1 2700 110 0 0 1 0 0
20 47 -1 2900 242 0 0 1 2880 2944
21 47 -1 3000 305 0 0 1 2945 3070
22 43 1 3350 160 0 0 1 0 0
23 46 -1 3480 240 0 0 1 0 0
24 43 1 3730 160 0 0 1 0 0
25 46 -1 3780 290 0 0 1 0 0
26 47 -1 3770 120 0 0 1 3670 3870
27 47 -1 3898 120 0 0 1 3798 3998
28 21 -1 60 30 1024 10 1 0 0
29 21 -1 1175 30 45 10 1 0 0 
30 21 -1 1290 30 45 10 1 0 0 
31 21 -1 1420 30 45 10 1 0 0 
32 21 -1 1549 30 45 10 1 0 0 
33 21 -1 1610 120 45 10 1 0 0
34 21 -1 1675 180 250 10 1 0 0
35 21 -1 2058 30 120 10 1 0 0 
36 21 -1 2250 30 560 10 1 0 0 
37 21 -1 2826 118 45 10 1 0 0 
38 21 -1 2880 180 45 10 1 0 0 
39 21 -1 2945 236 120 10 1 0 0 
40 21 -1 3200 30 22 10 1 0 0 
41 21 -1 3328 30 22 10 1 0 0 
42 21 -1 3455 30 22 10 1 0 0 
43 21 -1 3580 30 490 10 1 0 0 