28
0 47 -1 550 120 64 64 1
1 47 -1 630 120 64 64 1
2 47 -1 700 120 64 64 1
3 43 1 680 190 64 64 1
4 45 -1 680 100 64 64 1
5 43 1 880 190 64 64 1
6 46 -1 1100 250 64 64 1
7 43 1 1150 190 64 64 1
8 46 -1 1440 270 64 64 1
9 43 1 1550 220 64 64 1
10 43 1 1780 280 64 64 1
11 45 -1 1900 220 64 64 1
12 43 1 2295 160 64 64 1
13 43 1 2370 280 64 64 1
14 48 -1 2435 247 64 64 1
15 45 1 2500 110 64 64 1
16 47 -1 2600 247 64 64 1
17 43 1 2650 290 64 64 1
18 50 -1 2700 110 64 64 1
19 47 -1 2900 242 64 64 1
20 47 -1 3000 305 64 64 1
21 43 1 3350 160 64 64 1
22 46 -1 3480 240 64 64 1
23 43 1 3730 160 64 64 1
24 46 -1 3780 290 64 64 1
25 47 -1 3770 120 64 64 1
26 47 -1 3898 120 64 64 1
27 21 -1 300 20 1550 10 1