30
0 47 -1 480 120 64 64 0 380 580
1 47 -1 580 120 64 64 1 480 680
2 47 -1 670 120 64 64 1 570 770
3 45 1 450 100 64 64 70 0 0
4 47 -1 870 120 64 64 1 770 970
5 43 1 660 165 64 64 70 0 0
6 43 1 850 165 64 64 1 0 0
7 46 -1 1100 251 64 64 1 0 01
8 43 1 1150 190 64 64 1 0 0
9 46 -1 1440 270 64 64 1 0 0
10 43 1 1550 220 64 64 1 0 0
11 43 1 1780 280 64 64 1 0 0
12 45 -1 1900 220 64 64 1 0 0
13 43 1 2295 160 64 64 1 0 0
14 43 1 2370 280 64 64 1 0 0
15 48 -1 2435 247 64 64 1 0 0
16 45 1 2500 110 64 64 1 0 0
17 47 -1 2600 247 64 64 1 0 0
18 43 1 2650 290 64 64 1 0 0
19 50 -1 2700 110 64 64 1 0 0
20 47 -1 2900 242 64 64 1 0 0
21 47 -1 3000 305 64 64 1 0 0
22 43 1 3350 160 64 64 1 0 0
23 46 -1 3480 240 64 64 1 0 0
24 43 1 3730 160 64 64 1 0 0
25 46 -1 3780 290 64 64 1 0 0
26 47 -1 3770 120 64 64 1 0 0
27 47 -1 3898 120 64 64 1 0 0
28 21 -1 60 70 1014 10 1 0 0
29 21 -1 1185 70 25 10 1 0 0 
30 21 -1 1279 70 25 0 1 0 0 
31 21 -1 1409 70 25 10 1 0 0 
32 21 -1 1537 70 25 10 1 0 0 